00001000101010100000
00010100000000000000
00010000100100000000
00010000000000001000
00010000010000000000
00010000000000001000
00000100010000000000
00000000000000000000
00000000010010000000
00000000000101000000
00000000100000000000
00000000000000000000
00000000000000000000
00000000000000010000
00000000000010010000
00000010010000000000
00000000000000000000
00000010000000000000
00000010000000000000
